1111111111111111
1000100000000001
1000111111000111
1000000000000001
1000100000000001
1000100000000001
1000100000000001
1000100000000001
1000100000000001
1000100000000001
1000000000000001
1000000000000001
1000000000000001
1000000000000101
1000000000000001
1111111111111111